1101110001
0010001110
1011001100
1110000011
1110011111
0011100001
1010011100
1100010101
0101000101
1010001010